########################
#                      #
#   @@@@@@@@@@@@@@@@@   #
#   @...............@   #
#   @...............@   #
#   @...............@   #
#   @...............@   #
#   @.......B.......@   #
#   @.......###.....@   #
#   @.......###.....@   #
#   @.......###.....@   #
#   @...............@   #
#   @...............@   #
#   @...............@   #
#   @.......P.......@   #
#   @...............@   #
#   @@@@@@@@@@@@@@@@@   #
#                      #
########################